000000000000000000000000000000
000000000000000000000000000000
000000000000000000000000000000
000000222222222222222222220000
000000200000000000000000020000
000000000000000000000000000001
000000000000000000000000000011
000000000000000000000000000110
110003333333333333333300001100
011000000000000000000000011000
001100000000000000000000010000
000011000000000000000000110000
000001100000000000000001100000
000000111000000000000011000000
000000001100000000000110000000
000000000010000000001100000000
000000000000000000001000000000
000000000000000000000000000000
000000000000111111000000000000
000000000000111111000000000000
000000000000110011000000000000
000000000000110011000000000000
