444444444444444444444444444444
444444444444444444444444444444
444444444444444444444444444444
444444444444444444444444444444
444444444444444444444444444444
444444444444444444444444444444
444444444444444444444444444444
444444444444444444444444444444
444444444444444444444444444444
444444444444444444444444444444
444444444444444444444444444444
444444444444444444444444444444
444444444444444444444444444444
444444444444444444444444444444
444444444444444444444444444444
444444444444444444444444444444
444444444400000000004444444444
444444444400000000004444444444
444444444400111111004444444444
444444444400111111004444444444
444444444400110011004444444444
444444444400110011004444444444
