000000000000000000000000000000
000000000000000000000000000000
000000000000000000000000000000
000000000000000000000000000000
000000000000000000004444000000
000000000000000040400004000000
000000000014444440000044000000
000000000000411141414404000000
000004040444414400110444000000
004040004000414440114444440000
040000440444404144444404000000
400004440044141444444444100000
000004044444114444441444100000
000004404444444444444014000000
000000004404411414144440000000
400000000114444400014100000000
040404004000000000004000000000
000000000000000000000000000000
000000000000111111000000000000
000000000000111111000000000000
000000000000110011000000000000
000000000000110011000000000000
