000000000000000000000000000000
000000000000000000000000000000
000000000000000000000000000000
000000000000000000000000000000
000000000000000000000000000000
000000000000000000000000000000
000000000000000000000000000000
000000000000000000000000000000
000000000000000000000000000000
000000000000000000000000000000
000000000000000000000000000000
000000000000000000000000000000
000000000000000000000000006600
000000000000000000000000666060
000000000000000000000066600066
000000000000000000000066000006
000000000000000000000066000006
000000000000000000000066660000
000000000000111111000066666006
000000000000111111000066666006
000000000000110011000066666006
000000000000110011000066666666
