666666666666666666666666666666
666666666666666666666666666666
666666666666666666666666666666
666666666666666666666666666666
666666666666666666666666666666
666666666666666666666666666666
666666666666666666666666666666
666666666666666666666666666666
666666666666666666666666666666
666666666666666666666666666666
666666666666666666666666666666
666666666666666666666666666666
666666666666666666666666666666
666666666666666666666666666666
666666666666666666666666666666
666666666666666666666666666666
666666666600000000006666666666
666666666600000000006666666666
666666666600111111006666666666
666666666600111111006666666666
666666666600110011006666666666
666666666600110011006666666666
