000000000000000000000000000000
000000000000000000000000000000
000000000000000000000000000000
000111111111111111110000000000
000222222222222222220000000000
000333333333333333330000000000
000444444444444444440000000000
000444444444444444440000000000
000555555555555555550000000000
000555555555555555550000000000
000666666666666666660000000000
000666666666666666660000000000
000000000000000000000000000000
000000000000000000000000000000
000000000000000000000000000000
000000000000000000000000000000
000000000000000000000000000000
000000000000000000000000000000
000000000000111111000000000000
000000000000111111000000000000
000000000000110011000000000000
000000000000110011000000000000
