000000000444444444444400000000
000000000444444444444400000000
000000000444444444444400000000
000000000444444444444400000000
000000000444444444444400000000
000000000444444444444400000000
000000000444444444444400000000
000000000444444444444400000000
000000000333333333333300000000
000000001333333333333310000000
000000001111111111111110000000
000000002000000000550000000000
000000002000000000550000000000
000000002000000000550000000000
000000002000000000550000000000
000000002000000000550000000000
000000002000000000000000000000
000000002000000000000000000000
000000002000111111000000000666
000000002000111111000000000666
000000002000110011000000000666
000000002000110011000000000666
