000000000000000000000000000000
000000000000000000000000000000
000000000000000000000000000000
000000000000000000000000000000
000000000000000000001101110000
000000000000000011110111010111
000000000001110111111111000010
000000000110111001103310000100
000000011013333031301330110000
000000110113333111333133330000
000001101110130330333010330000
000001113333310133330133300000
000000111011113333310011000000
000000111011033031133330000000
000000001001333333333000000000
000000000000333300300000000000
000000000300000000000000000000
000000000300000000000000000000
000000000000111111000000000000
000000000000111111000000000000
000000000000110011000000000000
000000000000110011000000000000
