000000000000000000000000000000
000000000000000000000000000000
000000000000000000000000000000
000000003333333333333330000000
000000003222333333322230000000
000000003232223332223230000000
000000003333333333333330000000
000000000000000000000000000000
000000000000000000000000000000
000000110000000000000011000000
000000110000000000000011000000
000000110000000000000011000000
333000222222222222222222000333
333000211111133331111112000333
333000222222222222222222000333
000000000000000000000000000000
000000000000000000000000000000
000000000000000000000000000000
000000000000111111000000000000
000000000000111111000000000000
000000000000110011000000000000
000000000000110011000000000000
