666666666666666666666666666666
666666666666661116666666666666
666666666666661116666666666666
666661116666661116661116666666
666666666666666666666666666666
666666666666666166666666666666
661111666666666166666611116666
666666666666666666666666666666
666666666666661116666666666666
111666666666661116666666666111
666666666666661116666666666666
666666666666666666666666666666
000000003333333333333300000000
000000000000000000000000000000
000000000000000000000000000000
000000000000000000000000000000
000000000000000000000000000000
000000000000000000000000000000
000000000000111111000000000000
000000000000111111000000000000
000000000000110011000000000000
000000000000110011000000000000
