000000000000000000000000000000
000000000000000000000000000000
000222222222222222222222222333
000000666666116661166666662333
000000666666116661166666662333
111112666666666666666666662333
111112666666666666666666662333
111112666666666666666666662333
000002666666666666666666662333
000002666666666666666666662333
000002666666666666666666662333
000002666222221112222226662333
000002666666666666666666662333
000002666666666666666666662000
000002666666666666666666662000
000002000222220002222220002000
000000000000000000000000000000
000000000000000000000000000000
000000000000111111000000000000
000000000000111111000000000000
000000000000110011000000000000
000000000000110011000000000000
