000000000000000000000000000000
000000000000000000000000000000
600000000000000000000000000006
600000000000000000000000000006
600000000000000000000000000006
600000000000000000000000000006
600000000000000000000000000006
602020202020200002020202020206
600000000000200002000000000006
600000000000200002000000000006
113333333333366663333333333311
110000000000000000000000000011
110000000000000000000000000011
111111111111111111111111111111
111111111111111111111111111111
111111111111111111111111111111
111111111100000000001111111111
000000000000000000000000000000
000000000000111111000000000000
000000000000111111000000000000
000000000000110011000000000000
000000000000110011000000000000
