000000000000000000000000000000
000000000000006666000000000000
666600000000001221000000006666
221600000000001331000000006122
666600000000001111000000006666
000000000000000000000000000000
000000000662266666622660000000
000000000226633333366220000000
000000000666633333366660000000
000000000661166666611660000000
000000000000000000000000000000
000000000000000000000000000000
661166116611661166116611661166
116611661166116611661166116611
000000000000000000000000000000
000000000000000000000000000000
000000000000000000000000000000
000000000000000000000000000000
000000000000111111000000000000
000000000000111111000000000000
000000000000110011000000000000
000000000000110011000000000000
