444444444444444444444444444444
444444444444444444444444444444
000222222222222222222222222000
666666666666623326666666666666
161666666666622226666666666161
111000000000000000000000000111
101000000000000000000000000101
000000000000010010000000000000
000000000000011110000000000000
000000000000010010000000000000
000101000000000000000000101000
000111000000000000000000111000
000101000000000000000000101000
000000000000000000000000000000
000000000033333333330000000000
444444444444444444444444444444
444444444400000000004444444444
000000000000000000000000000000
000000000000111111000000000000
000000000000111111000000000000
000000000000110011000000000000
000000000000110011000000000000
