444444444444444444444444444444
444414444444444444444444414444
441114411111111111111114411144
440004400000666666000004400044
440004400006333333600004400044
440004400063333333360004400044
440004400633333333336004400044
441014416666666666666614410144
441014416666666666666614410144
110002200000000000000002200011
000000000000000000000000000000
000000000000002200000000000000
666660000000023320000000066666
333360000000233332000000063333
333360000000023320000000063333
666660000000002200000000066666
000000000000000000000000000000
000000000000000000000000000000
000000000000111111000000000000
000000000000111111000000000000
000000000000110011000000000000
000000000000110011000000000000
