100000000000000000000000000001
100000000000000000000000000001
100000000000000000000000000001
100000000000000000000000000001
100000000222222222222200000001
100000000666666666666600000001
100000000066666666666000000001
120000000006662226660000000021
000000000000662226600000000000
000000000000062226000000000000
123333333200000000000233333321
123333333200000000000233333321
123333333200000000000233333321
123333333200000000000233333321
666666666600000000000666666666
666666666600000000000666666666
666666666600000000000666666666
666666666600000000000666666666
555555555500111111000555555555
555555555500111111000555555555
555555555500110011000555555555
555555555500110011000555555555
