445566666666666666666666665544
445566666666666666666666665544
445566666226666666662266665544
445500001113333333331110005544
445500000111333333311100005544
445500000011133333111000005544
445500000001113331110000005544
445500000000111111100000005544
445500000000011111000000005544
445500000000001110000000005544
445500000000000100000000005544
445500000000000000000000005544
445500000000000000000000005544
445500000000000000000000005544
445500000000000000000000005544
445500000000000000000000005544
445500000000000000000000005544
445500000000000000000000005544
441166666600111111006666661144
441166666600111111006666661144
441166666600110011006666661144
441166666600110011006666661144
