444444444444444444444444444444
444444444444444444444444444444
444444424444444444444424444444
442222226622222222226622222244
442666666666666366666666666244
442666666666666366666666666244
442551111111111111111111155244
442555555555555255555555555244
442555555555555255555555555244
442555555555555255555555555244
442555555555555255555555555244
442112222222233333222222211244
442555555555555555555555555244
442555555555555555555555555244
442555555555555555555555555244
442444222222255555222222444244
442444555500000000005555444244
442444555500000000005555444244
445444555500111111005555444544
445444555500111111005555444544
445444555500110011005555444544
445444555500110011005555444544
