000000000000000000000000000000
000000000000000000000000000000
000222222222222222222222222000
000000000000000000000000000000
000000000000000000000000000000
222222222222200002222222222222
000000000000000000000000000000
000000000000000000000000000000
000000000002222222200000000000
000000000002222222200000000000
000000000002222222200000000000
000000000000000000000000000000
000000000000000000000000000000
000000000000000000000000000000
000000000000000000000000000000
000000000000000000000000000000
000000000000000000000000000000
000000000000000000000000000000
000000000000111111000000000000
000000000000111111000000000000
000000000000110011000000000000
000000000000110011000000000000
