000000000000000000000000000000
000000000000000000000000000000
000020000000000000000000020000
000020022222222222222220020000
000020000000000000000000020000
000020000000000000000000020000
000020000000000000000000020000
000020000000000000000000020000
000020000000000000000000020000
000020000000000000000000020000
000020000000000000000000020000
000022222220000000022222220000
000020000000000000000000020000
000020000000000000000000020000
000020000000000000000000020000
000020000000000000000000020000
000000000000000000000000000000
000000000000000000000000000000
000000000000111111000000000000
000000000000111111000000000000
000000000000110011000000000000
000000000000110011000000000000
