000000000000000000000000000000
000000000000000000000000000000
000000100000000000000001000000
111111111111111211111111111111
000000000000022222000000000000
000000000000021112000000000000
222000000000022222000000000222
000000000000000000000000000000
000000000000000000000000000000
000000000000000000000000000000
000000000000000000000000000000
000000000000000000000000000000
000000000000000000000000000000
000000000000000000000000000000
000000000000000000000000000000
000000000000000000000000000000
000000000000000000000000000000
000000000000000000000000000000
000000000000111111000000000000
000000000000111111000000000000
000000000000110011000000000000
000000000000110011000000000000
