000000010000000000000001000000
000000001000000000000010000000
000000000100000000000100000000
000000000010000000001000000000
000000000001000000010000000000
000000000000111111100000000000
000000000000111111100000000000
000000000000111111100000000000
222000000000111111100000000222
000000000000111111100000000000
000000000001111111110000000000
000000000011000000011000000000
000000000110000000001100000000
000000001100000000000110000000
000000011000000000000011000000
000000110000000000000001100000
000001100000000000000000110000
000011000000000000000000011000
000110000000111111000000001100
001100000000111111000000000110
111000000000110011000000000011
110000000000110011000000000011
