000000000000000100000000000000
000000000000000100000000000000
111222222222222222222222222111
000000000000000100000000000000
000000000000000100000000000000
111222222222222222222222222111
000000000000002220000000000000
000000000000002120000000000000
111000000000002220000000000111
111222222211122222111222222111
000000000000001110000000000000
000000000000000000000000000000
000000000000000000000000000000
000000000000000000000000000000
000000000000000000000000000000
000000000000000000000000000000
000000000000000000000000000000
000000000000000000000000000000
000000000000111111000000000000
000000000000111111000000000000
000000000000110011000000000000
000000000000110011000000000000
